



	EA textures/wall.png
     NO	 	  	 	 textures/wall.png


C 42,42,53

F 41,39,32

SO textures/wall.png


WE textures/wall.png


111111111111111111111111111111111
100000000010001000100000011100001
100000000010001000100000011100001
100011000010001000100000011100001
100100000010001000100000011100001
100000000010001000100000000000001
100000000000N00000100000011100001
100000000010001000100010011100001
100001000010001000000000011100001
100000000010001001000000011100001
100000000010001000100000011100001
100001000010001000100000011100001
100000000010001000100000011100001
100000010010001000100000011100001
100000000010001000100000011100001
111111111111111111111111111111111
