

 
EA            textures/wall1.png
NO       textures/wall2.png



C 201,201,0

F 136,136,136


SO textures/wall3.png


WE textures/wall4.png


1111111111
1000100001
100WD00001
1000100001
1111111111
        11
        11