


EA textures/wall1.png
NO textures/wall2.png



C 201,201,201

F       136,136,136


SO textures/wall3.png


WE textures/wall4.png


111111111111111111111111111111111
100000000010001000100000011100001
100000000010001000100000011100001
100011000010001000100000011100001
10010000001000D000100000011100001
100000000010001000100000000000001
100000000000N0D000100000011100001
100000000010001000100010011100001
100001000010001000000000011100001
100000000010001001000000011100001
100000000010001000100000011100001
100001000010001000100000011100001
100000000010001000100000011100001
100000010010001000100000011100001
100000000010001000100000011100001
111111111111111111111111111111111
