

EA textures/wall8.png
NO textures/wall6.png



C 201,201,201

F       136,136,136


SO textures/wall5.png


WE textures/wall7.png




111111111111111
100000100000001
100S0011111111111111111111
10000010000000000000010001
10000010000000000000000001
10000010000000000000010001
11101111111011111111110001
110000110000001      10001
100000010000001      10001
100000010000001      10001
10000000000000111111111011111111111
10000001000000100000000000000000001
100000010000001000000000000000000011111
110000110000001001110000000000110010001
111111111111111001000000000000010010001
              1000000000000000000010001
              1000000000000000000010001
              1000000000000000000000001
              1000000000000000000010001
              1000000000000000000010001
              1001000000000000010010001
              1001100000000000110010001
              1000000000000000000010001
              1000000000000000000010001
              1111111111111111111110001
                                  10001
                               11110001111
                               10000000001
   1111111111111               10000000001
   1000000000001               10000000001
   1000000000001               10000000001
   1000000000001               10000000001
   1000000000001               10000000001
   1000000000001               10000000001
   10011111111111111111111     11111011111
   10000000000000000000001       100001
   11110000000000000000001       100001
      10000000000000000001       100001
  1111100000000000011101111111111100001
  1000000000000000010000000000000000001
  1000100000000000010000000000000000001
  1000100000000000010000000000000000001
  1000111111011111110000000000000000001
  1000000010001    11101111111111111111
  1000000010001    100000000001
  1000000010001    100000000001
  1111011110001    100000000001
    10001 10001    100000000001
    10001111111    100000000001
    10000000001    100000000001
    11111100001    111111011111
         110001        10001
          10001        10001
           10001       10001
            10001      11111
             10001
              10001
               11111